111111111111111111111111111111111111111111
100000000000000000000000000000000000000001
100000000000000000000000000000000000000001
100000000000000000000000000000000000000001
100000000000000000000000111000000000000001
100000000000110000000000001111000000000001
100000000000011100000000000001110000000001
100000000000000011100000000000001100000001
100000000000000000110000000000000100000001
100000000000000000001000000000000100000001
100000000000000000000110000000001100000001
100000000000000000000011000000011000000001
100000000110000000000000111001110000000001
100000000011100000000000000111000000000001
100000000000111000000000000000000000000001
100110000000011000000000000000000000000001
100011110011110000000000000000000000000001
100000011100000000000000000000000000000001
100000000000000000000000000000000000000001
111111111111111111111111111111111111111111
