111111111111111111111111111111111111111111
100000000000000100000000000000000000000001
100000000000000100000000000001000000000001
111111111111000101111001110001100001100001
100000000001000100001110111000100000100001
100000000001000100000000000000000000100001
100000000001000100000000000000000000000001
100000000001000100010000000000100000000101
100000000001000000010000110000110001001101
100000000001000000010001100000000000000001
100000000001000100010000000000000000000001
100000000001000100011000000011100001000001
100000000001000100000000000010000011000001
100000000001000100010001000000000010000001
100011111111000100010000000000000000000001
100000000000000100110000000010000000000001
100000000000000100100001000110000000011001
100000000000000100000111001100000000011001
100000000000000000000000000000000000000001
111111111111111111111111111111111111111111
