11111111111111111111
10000000000000000001
10000000000000000001
11111111100000010001
10000001000000010001
10000001000000010001
10000001000000010001
10000001000000010001
10000000000100011001
10000000000100000001
10000000000100000001
10000000000100000001
10000000000000000001
10000010000000000001
10000011000001100001
10000001111111000001
10000000000000000001
10000000000000000001
10000000000000000001
11111111111111111111
