11111111111111111111
10000000000000000001
10000000000000000001
11111111100000010001
10000001001100010001
10000001001100010001
10000001101100010001
10000001111100010001
10000001111111011001
10000011101111000001
10000111001110000001
10000101111100010001
10000110000111011001
10000010000001111001
10000011000001101101
10000001111111000001
10000000000000000001
10000000000000000001
10000000000000000001
11111111111111111111
