11111111111111111111
10000000000000000001
10000000000000000001
10000000000001100001
10000111111111000001
10000000000000000001
10000000000000000001
10000000000010000001
10000000000011000001
10000000001001000001
10000000001001000001
10000000001001000001
10000000001000000001
10000000001000000001
10000000001000000001
10000000001000000001
10000000001000000001
10000000000000000001
10000000000000000001
11111111111111111111
