11111111111111111111
10000000000000000001
10000000000000000001
10000000000000000001
11111111111111110001
10000000000000010001
10000000000000010001
10011000000000010001
10000001001111110001
10000001001000000001
10000001001000000001
10001111001001000001
10000000000001001001
10000000000001001001
10000000000001001001
10010000111000000001
10011100101000000001
10000000101111100001
10000000000000000001
11111111111111111111
