111111111111111111111111111111111111111111
100000000000000000011110000000000000000001
100000000000000000010000000000000000000001
100000000000000000000000000011111000000001
100000000000000000000000000000000000000001
100000000000000000000000000000000000000001
100000000000000000000000000000000000111111
100000000000000000010000000000000011000011
100000000000000001111111000000111111000001
100000000000111111010000000000001001000111
100000000001100000000000000000001000001101
100000000001000000000000000000001000000011
100000000001000000000001110000000000000011
100000000001100000010000100000000000011111
100000000000111110010000100000000000011001
100000000000000000010001001111111111100011
100000000000000000010011111000000000000001
100000000000000000010010000000000000000011
100000000000000000010000000000000000000011
111111111111111111111111111111111111111111
