11111111111111111111
10000000000100000001
10000000000111111111
10000000000000000001
10000000000000000001
10000000000000000001
10000000000111110001
10000000000100010001
10000000000100010001
10000000000100010001
10000000000000010001
10000000000000000001
10000000000000000001
10000000000000000001
10000000000000000001
10000000000000000001
10000000000000000001
10000000000000000001
10000000000000000001
11111111111111111111
