11111111111111111111
10000000000000000001
10000000000000000001
10000000000000000001
11111111111111100001
10000000000000100001
10000000000000100001
10011000010000100001
10010000111000100001
10011100001000110001
10000100001000010001
10001100001000010001
10001000011111110001
10001000000000010001
10001000000000010001
10001111100011110001
10000000111110000001
10000000000000000001
10000000000000000001
11111111111111111111
